NO img/greystone.xpm
WE img/purplestone.xpm
EA img/red.xpm


         F 20,20,20

C 0,36,225
SO img/eagle.xpm


11111111
1010000011
100000111111
1000000000001
100S000000011
1000000000001
100000000111
111111111