
NO img/greystone.xpm
WE img/purplestone.xpm
EA img/red.xpm


         F                 001,0,0

C 0,36,225
SO img/eagle.xpm


1111111
1010011
1000001
1000001
100S011
1000001
1000001
1111111



