
EA img/exit.xpm
WE img/item_2.xpm
NO img/Untitled.xpm


         F                  255,255,255

C 0,36,225
SO img/enemy_front.xpm


1111111
1110011
1000001
1000001
100S011
1000001
1000001
1111111



