
EA img/exit.xpm
WE img/item_2.xpm
NO img/Untitled.xpm


         F                  23,150,100

C 6,5,255
SO img/enemy_front.xpm


111111111111111111111111
100000000000000000000001
100000000000000000000001
100000000000000000000001
100000000000000000000001
100000000000000000000001
100000000000000000000001
100000000000000000000001
100000000000000000000001
100000000000000000000001
100000000000000000000001
100000000000000000000001
100000000000000000000001
100000000000000000000001
100000000000000000000001
100000000000000000000001
100000000000000000000001
100000000000000000000001
100000000000000000000001
100000000000000000000001
100000000000000000000001
100000000000000N00000001
100000000000000000000001
111111111111111111111111



